{
  "timestamp": "2026-02-25T18:33:19.930Z",
  "mode": "apply",
  "summary": {
    "totalLevels": 200,
    "cleanLevels": 142,
    "impactedLevels": 58,
    "rebuilt": 58,
    "failed": 0,
    "cluePoolSize": 8056
  },
  "impactedIds": [
    "ch51",
    "ch53",
    "ch57",
    "ch59",
    "ch62",
    "ch67",
    "ch68",
    "ch72",
    "ch79",
    "ch81",
    "ch84",
    "ch85",
    "ch87",
    "ch92",
    "ch98",
    "ch99",
    "ch104",
    "ch107",
    "ch108",
    "ch111",
    "ch112",
    "ch117",
    "ch123",
    "ch124",
    "ch129",
    "ch136",
    "ch137",
    "ch141",
    "ch143",
    "ch146",
    "ch149",
    "ch152",
    "ch154",
    "ch155",
    "ch157",
    "ch159",
    "ch160",
    "ch166",
    "ch167",
    "ch170",
    "ch174",
    "ch175",
    "ch178",
    "ch179",
    "ch180",
    "ch185",
    "ch186",
    "ch188",
    "ch189",
    "ch190",
    "ch191",
    "ch192",
    "ch193",
    "ch194",
    "ch196",
    "ch198",
    "ch199",
    "ch200"
  ],
  "rebuiltIds": [
    "ch51",
    "ch53",
    "ch57",
    "ch59",
    "ch62",
    "ch67",
    "ch68",
    "ch72",
    "ch79",
    "ch81",
    "ch84",
    "ch85",
    "ch87",
    "ch92",
    "ch98",
    "ch99",
    "ch104",
    "ch107",
    "ch108",
    "ch111",
    "ch112",
    "ch117",
    "ch123",
    "ch124",
    "ch129",
    "ch136",
    "ch137",
    "ch141",
    "ch143",
    "ch146",
    "ch149",
    "ch152",
    "ch154",
    "ch155",
    "ch157",
    "ch159",
    "ch160",
    "ch166",
    "ch167",
    "ch170",
    "ch174",
    "ch175",
    "ch178",
    "ch179",
    "ch180",
    "ch185",
    "ch186",
    "ch188",
    "ch189",
    "ch190",
    "ch191",
    "ch192",
    "ch193",
    "ch194",
    "ch196",
    "ch198",
    "ch199",
    "ch200"
  ],
  "failedIds": []
}